Frionivalis > eon	(['Ribbons/Silk', 'Jewelry/Filigree', 'Background'])
Susie > brierilee	(['Floral/Nature', 'Cute/Pastel', 'Background'])
blair > Villager	(['Jewelry/Filigree', 'Floral/Nature'])
Noetsie > Quasar	(['Clothing', 'Floral/Nature'])
Vaer > hui	(['Ribbons/Silk', 'Jewelry/Filigree', 'Floral/Nature'])
Irmingard > Tired	(['Clothing', 'Jewelry/Filigree'])
brierilee > Valkyrie	(['Ribbons/Silk', 'Jewelry/Filigree'])
Olga > Celiane	(['Floral/Nature', 'Hair/Wigs', 'Cute/Pastel', 'Background'])
queercore > SilverSeravilo	(['Clothing', 'Repose'])
CloudiiSkii > Elaryi	(['Clothing', 'Plushie/Fake Companion'])
Cattrin > ZOMBIE	(['Jewelry/Filigree', 'Floral/Nature', 'Repose'])
ReddRoomba > genie	(['Body Markings/Patterns', 'Background'])
Fantasy > Aza	(['Floral/Nature', 'Food/Objects'])
eon > Celty	(['Ribbons/Silk', 'Clothing', 'Jewelry/Filigree'])
genie > Fantasy	(['Clothing', 'Floral/Nature', 'Hair/Wigs'])
Dread > Olga	(['Clothing', 'Jewelry/Filigree'])
Kimii > ambien	(['Clothing', 'Food/Objects', 'Background'])
NeonHeart > Dread	(['Clothing', 'Metal/Armor', 'Jewelry/Filigree'])
Auri > heli	(['Clothing', 'Body Markings/Patterns', 'Background'])
Quasar > CloudiiSkii	(['Ribbons/Silk', 'Floral/Nature'])
Eschtaaa > Thalies	(['Floral/Nature', 'Repose'])
Desnik > Auri	(['Metal/Armor', 'Ribbons/Silk', 'Clothing', 'Body Markings/Patterns', 'Cute/Pastel', 'Background', 'Floral/Nature', 'Jewelry/Filigree'])
LeafeonWarrior > Snowy	(['Plushie/Fake Companion'])
heli > NeonHeart	(['Jewelry/Filigree', 'Metal/Armor'])
Snowy > Mintiimermaid 	(['Clothing', 'Cute/Pastel'])
SilverSeravilo > Desnik	(['Clothing', 'Floral/Nature', 'Hair/Wigs', 'Body Markings/Patterns'])
Elaryi > Irmingard	(['Ribbons/Silk', 'Hair/Wigs'])
diabo > Noetsie	(['Clothing', 'Hair/Wigs', 'Repose'])
Tegu > Frionivalis	(['Floral/Nature', 'Background'])
Thalies > Lizzi	(['Ribbons/Silk', 'Clothing', 'Repose', 'Floral/Nature', 'Jewelry/Filigree'])
Celiane > Tegu	(['Floral/Nature', 'Food/Objects', 'Background'])
Amberdash > Cattrin	(Force Match)
Celty > Amberdash	(['Background'])
Villager > Cattrin	(['Body Markings/Patterns'])
Lizzi > blair	(['Background', 'Repose'])
ambien > Eschtaaa	(['Plushie/Fake Companion'])
Honiydu > Kimii	(['Clothing', 'Spooky/Horror'])
LittleBlackCat > LeafeonWarrior	(['Food/Objects', 'Repose'])
Mintiimermaid  > VALVERA	(['Clothing', 'Hair/Wigs', 'Plushie/Fake Companion', 'Repose'])
Tired > Susie	(['Clothing', 'Floral/Nature', 'Background'])
VALVERA > Honiydu	(['Clothing', 'Body Markings/Patterns', 'Background'])
Valkyrie > queercore	(['Clothing', 'Hair/Wigs'])
hui > ReddRoomba	(['Clothing', 'Metal/Armor', 'Jewelry/Filigree'])
Aza > LittleBlackCat	(['Food/Objects', 'Repose'])
ZOMBIE > Vaer	(['Jewelry/Filigree', 'Repose'])
